11111111111111111111111111111111111111111111111111
10000000000000000000000000000000000000000000000001
10000000000000000000000000000000000000000000000001
10000000000000000000000000000000000000000000000001
10000000000000000000000000000000000000000000000001
10000000000000001000100010001000100000000000000001
10000000000000000000000000000000000000000000000001
10000000000000000000000000000000000000000000000001
10000000000000100010001000100010001000000000000001
10000000000000000000000000000000000000000000000001
10000000000000000000000000000000000000000000000001
10000000002020202020202020202020202020200000000001
10000000000000000000000000000000000000000000000001
10000000000000000000000000000000000000000000000001
10000002020202020202020202020202020202020200000001
10000000000000000000000000000000000000000000000001
10000000000000000000000000000000000000000000000001
10002020202020202020202020202020202020202020200001
10000000000000000000000000000000000000000000000001
10000000000000000000000000000000000000000000000001
10002222222222000000222222222200000022000000220001
10002222222222000000222222222200000022000000220001
10002200000022000000220000000000000022000000220001
10002200000022000000220000000000000022000000220001
10002222222222000000222222222200000022000000220001
10002222222222000000222222222200000022000000220001
10002200000022000000000000002200000022000000220001
10002200000022000000000000002200000022000000220001
10002200000022000000222222222200000022222222220001
10002200000022000000222222222200000022222222220001
10000000000000000000000000000000000000000000000001
10000000000000000000000000000000000000000000000001
10002020202020202020202020202020202020202020200001
10000000000000000000000000000000000000000000000001
10000000000000000000000000000000000000000000000001
10000002020202020202020202020202020202020200000001
10000000000000000000000000000000000000000000000001
10000000000000000000000000000000000000000000000001
10000000002020202020202020202020202020200000000001
10000000000000000000000000000000000000000000000001
10000000000000000000000000000000000000000000000001
10000000000000100010001000100010001000000000000001
10000000000000000000000000000000000000000000000001
10000000000000000000000000000000000000000000000001
10000000000000001000100010001000100000000000000001
10000000000000000000000000000000000000000000000001
10000000000000000000000000000000000000000000000001
10000000000000000000000000000000000000000000000001
10000000000000000000000000000000000000000000000001
11111111111111111111111111111111111111111111111111
